################################################################
#  #       ###     ###       # #       #########       ####    #
#  #  ###########         #### ###            ##  ###  ###  ## #
#  #               #####            ###  ###      ###       ## #
#  #  ##########  #######   ##########   # #  #######  # ## ## #
#  #  ##     #######    ######           # #  #######    ## ####
#       ####  ##  ##  #  ##     ##  ###### ################ #  #
#########     ##      #   ####  ##  ######   ###            #  #
#       ##### ##  ######        ##  #             ###  ######  #
#######     # ####################  ##  #######   ###      ##  #
#     ####  # ##     #              ##  #     ##########       #
#  #######  # ##  ###################   # ######    #####  #####
#                          #           #  #  ##  ##    ###     #
#  ####################### #  ###  #####  ##    ####  #### #####
#  ####         ######## # #  ###         ###   ########   #   #
#          ###  ##       #   ###############    #        ### # #
# ############  ######## #######                # ########   # #
#     ##            ####             ############ ##       ### #
##        ####  ##          ###########              #########E#
################################################################
